1111111111
1P0CCCC0E1
1111111111