1111111111
1PCCCCCCE1
1111111111