11111111111111111111
10001P00010001000001
10000000100011100001
100010C001C000001001
10100001000010000101
11110000011100011001
11000001110001000001
100011000C000011C001
11111100001111C11111
11100000100001001001
10000011100001000011
11000011000011110001
10001100000100010001
1C100100011000001001
11100001000000100011
10000011100000100001
11100000011100000011
11E00100111000110001
11111111C00000000011
11111111111111111111
